222/999
FL-FL-FL-FL-FL-FL-FL-FL-FL-FL-WW-WW-WW-WW-WW-WW-WW-WW-WW-WW-WW-WW-WW-WW-WW-WW-WW-WW-WW-WW-;
FL-FL-FL-FL-FL-FL-FL-FL-FL-FL-WW-NW-IC-IC-IC-IC-IC-IC-FL-FL-FL-WW-WW-WW-WW-WW-WW-WW-WW-WW-;
FL-FL-FL-FL-FL-FL-FL-FL-FL-FL-WW-IC-WW-WW-WW-WW-WW-WW-WW-WW-FL-WW-WW-WW-WW-WW-WW-WW-WW-WW-;
WW-WW-WW-WW-WW-WW-WW-WW-WW-WW-WW-IC-WW-WW-WW-WW-WW-WW-WW-WW-FL-IC-IC-IC-IC-IC-IC-IC-FI-WW-;
WW-FI-IC-IC-IC-IC-IC-BO-IC-IC-IC-SE-WW-WW-WW-FL-FL-FL-FL-FL-FL-WW-WW-CH-WW-WW-FL-WW-WW-WW-;
WW-WW-WW-WW-FL-WW-WW-FL-WW-WW-WW-WW-WW-WW-WW-FL-WW-WW-FL-WW-CH-WW-WW-WW-WW-WW-FL-WW-WW-WW-;
FL-FL-FL-WW-FL-WW-WW-FL-WW-FL-FL-FL-FL-HP-WW-FL-WW-WW-FL-WW-WW-WW-WW-WW-WW-WW-FL-WW-WW-WW-;
FL-FL-FL-WW-FL-WW-WW-FL-WW-FL-FL-FL-FL-FL-WW-IS-WW-WW-KR-WW-WW-FL-WW-WW-WW-WW-FL-WW-WW-WW-;
FL-FL-FL-WW-FL-WW-WW-FL-BO-FL-DT-WW-DT-FL-WW-WW-WW-WW-WW-WW-WW-FL-WW-WW-WW-WW-FL-WW-WW-WW-;
FL-FL-FL-WW-FL-WW-WW-FL-WW-FL-FL-FL-FL-FL-FL-DR-BR-FL-WW-WW-WW-FL-WW-WW-WW-WW-CH-WW-WW-WW-;
FL-FL-FL-WW-FL-WW-WW-FL-WW-FL-FL-FL-FL-FL-FL-DR-BR-FL-WW-WW-WW-FL-WW-WW-WW-WW-WW-WW-WW-WW-;
FL-FL-FL-WW-TW-WW-WW-FL-WW-WW-FL-WW-WW-WW-FL-DR-BR-FL-FL-FL-FL-FL-WW-WW-WW-WW-WW-WW-WW-WW-;
FL-FL-FL-WW-TF-WW-WW-FL-WW-WW-FL-WW-FL-WW-FL-DR-BR-HW-HW-WW-WW-WW-WW-WW-WW-FL-FE-FL-WW-WW-;
FL-FL-FL-WW-TW-WW-WW-FL-WW-WW-FL-WW-FL-WW-FL-DR-BR-FL-FL-FL-FL-FL-FL-FL-FL-FL-WW-FL-FB-WW-;
FL-FL-FL-WW-TF-WW-WW-FL-FL-FL-RW-WW-FL-WW-SP-DR-BF-FL-HW-FL-WW-WW-WW-FI-WW-FL-FL-FL-WW-WW-;
FL-FL-FL-WW-CH-WW-WW-WW-FL-WW-WW-WW-FL-WW-FL-DR-BR-FL-HW-FL-WW-WW-WW-FI-WW-WW-WW-WW-WW-WW-;
FL-FL-FL-WW-WW-WW-WW-WW-FL-WW-FL-FL-FL-WW-FL-DR-BR-HW-HW-FL-WW-WW-WW-FI-WW-WW-WW-WW-WW-WW-;
FL-FL-FL-FL-FL-FL-FL-WW-FL-WW-WW-FL-WW-WW-FL-DR-BR-FL-FL-FL-WW-WW-WW-FI-WW-WW-WW-WW-WW-WW-;
FL-FL-FL-FL-WW-WW-WW-WW-DT-FL-WW-FL-WW-WW-WW-WW-WW-WW-WW-WW-WW-WW-WW-FI-WW-WW-WW-WW-WW-WW-;
FL-FL-FL-FL-WW-CH-FL-WA-FL-FL-WW-FL-WW-WW-FL-FL-TB-BH-FL-WW-WW-WW-WW-DO-WW-WW-WW-WW-WW-WW-;
FL-FL-FL-FL-WW-WW-WW-WW-FL-WW-WW-FL-WW-WW-WW-WW-WW-WW-WW-WW-WW-WW-WW-WN-WW-WW-WW-WW-WW-WW-;
FL-FL-FL-FL-FL-FL-FL-WW-WW-WW-FL-FL-FL-FL-FL-FL-FL-FL-FL-FL-FL-FL-WW-WW-WW-FL-FL-FL-FL-FL-;