050/000
WW-WW-WW-WW-WW-WW-WW-WW-WW-WW-WW-WW-WW-WW-WW-WW-WW-WW-WW-WW-WW-;
WW-WW-WW-WW-WW-WW-WW-WW-WW-WW-WW-WW-WW-WW-WW-WW-RW-RW-RW-RW-WW-;
WW-RW-RW-RW-RW-RW-RW-RW-RW-RW-RW-RW-RW-RW-RW-RW-WW-WW-WW-RW-WW-;
WW-RW-WW-WW-WW-WW-WW-WW-WW-WW-RW-WW-WW-WW-WW-RW-WW-WW-WW-RW-WW-;
WW-RW-WW-WW-WW-WW-RW-WW-WW-WW-RW-WW-WW-WW-WW-RW-RW-WW-RW-RW-WW-;
WW-RW-WW-WW-WW-WW-RW-WW-WW-WW-RW-WW-WW-WW-WW-RW-WW-WW-WW-RW-WW-;
WW-RW-WW-RW-RW-RW-RW-RW-RW-WW-RW-WW-WW-WW-WW-RW-WW-WW-WW-RW-WW-;
WW-RW-WW-RW-WW-RW-WW-WW-RW-WW-RW-WW-WW-WW-WW-RW-WW-WW-WW-RW-WW-;
WW-WW-RW-RW-WW-RW-WW-WW-RW-WW-RW-WW-WW-WW-RW-RW-RW-RW-RW-RW-WW-;
WW-WW-RW-WW-WW-RW-WW-WW-RW-RW-RW-WW-WW-WW-WW-RW-WW-WW-WW-RW-WW-;
WW-WW-RW-WW-WW-RW-WW-WW-WW-RW-WW-WW-WW-WW-WW-RW-WW-WW-WW-RW-WW-;
WW-WW-WN-WW-WW-RW-RW-RW-BR-BR-BR-WW-WW-WW-WW-RW-WW-WW-WW-RW-WW-;
WW-RW-WW-WW-WW-RW-WW-RW-BR-SP-BF-RW-RW-RW-RW-RW-RW-WW-WW-RW-WW-;
WW-RW-WW-RW-RW-WW-RW-WW-BR-BR-BR-WW-WW-WW-WW-WW-WW-WW-WW-RW-WW-;
WW-RW-WW-WW-RW-WW-RW-WW-WW-RW-WW-WW-RW-WW-RW-RW-RW-RW-RW-RW-WW-;
WW-RW-WW-WW-RW-WW-RW-WW-WW-RW-WW-WW-RW-WW-WW-WW-RW-WW-WW-RW-WW-;
WW-RW-WW-RW-RW-WW-RW-WW-WW-RW-WW-WW-RW-WW-WW-WW-RW-WW-WW-RW-WW-;
WW-RW-WW-RW-WW-WW-RW-WW-WW-RW-WW-WW-RW-WW-WW-WW-WW-WW-WW-RW-WW-;
WW-RW-RW-RW-RW-RW-RW-RW-RW-RW-RW-RW-RW-RW-RW-RW-RW-RW-RW-RW-WW-;
WW-WW-WW-WW-WW-WW-WW-WW-WW-WW-WW-WW-WW-WW-WW-WW-WW-WW-WW-WW-WW-;