200/999
HW-HW-HW-HW-HW-HW-HW-HW-HW-HW-HW-HW-HW-HW-HW-HW-HW-HW-HW-HW-HW-HW-HW-HW-HW-HW-HW-HW-HW-HW-HW-;
HW-HW-HW-HW-HW-HW-HW-HW-HW-HW-HW-HW-HW-HW-HW-HW-HW-HW-HW-HW-HW-HW-HW-HW-HW-HW-HW-HW-HW-HW-HW-;
HW-HW-HW-FL-CH-HW-HW-HW-HW-HW-HW-HW-HW-HW-HW-HW-HW-HW-HW-HW-HW-HW-HW-HW-HW-HW-HW-HW-HW-HW-HW-;
HW-HW-HW-FL-HW-HW-HW-FL-FL-FL-FL-FL-FL-FL-FL-FL-FL-FL-FL-FL-FL-FL-FL-FL-FL-HW-FL-FL-FL-FL-HW-;
HW-HW-HW-FL-HW-HW-HW-FL-HW-HW-HW-HW-HW-FL-HW-HW-FL-HW-HW-HW-HW-HW-FL-HW-FL-HW-FL-HW-HW-FL-HW-;
HW-HW-HW-FL-HW-HW-HW-FL-HW-HW-CH-HW-HW-FL-HW-HW-FL-HW-HW-HW-HW-HW-FL-HW-FL-HW-FL-FL-HW-FL-HW-;
HW-HW-HW-FL-CH-HW-HW-FL-HW-HW-FL-HW-HW-FL-HW-HW-FL-HW-HW-HW-HW-HW-FL-HW-FL-HW-HW-CH-HW-FL-HW-;
HW-HW-HW-HW-FL-HW-HW-FL-HW-HW-FL-HW-HW-HP-HW-HW-FL-HW-FL-FL-FL-FL-FL-HW-FL-HW-HW-HW-HW-FL-HW-;
HW-HW-HW-HW-FL-HW-HW-FL-HW-HW-FL-HW-HW-SP-HW-HW-FL-HW-FL-HW-HW-HW-FL-HW-FL-HW-CH-HW-HW-FL-HW-;
HW-HW-FL-FL-FL-FL-FL-FL-HW-HW-FL-HW-HW-HW-HW-HW-FL-HW-FL-FL-CH-HW-FL-HW-FL-HW-FL-FL-FL-FL-HW-;
HW-HW-FL-HW-HW-HW-HW-FL-FL-FL-FL-HW-HW-HW-HW-HW-FL-HW-HW-HW-HW-HW-FL-HW-FL-HW-HW-FL-HW-HW-HW-;
HW-HW-FL-CH-HW-HW-HW-HW-HW-HW-FL-HW-HW-HW-HW-HW-FL-FL-FL-FL-HW-HW-FL-HW-FL-HW-FL-FL-HW-HW-HW-;
HW-HW-FL-HW-HW-HW-HW-HW-HW-HW-FL-HW-HW-HW-HW-HW-HW-HW-HW-FL-HW-HW-FL-HW-FL-HW-FL-HW-HW-HW-HW-;
HW-HW-FL-HW-HW-HW-HW-HW-HW-HW-FL-FL-FL-HW-FL-FL-FL-FL-HW-FL-HW-FL-FL-HW-FL-HW-FL-FL-HW-HW-HW-;
HW-HW-FL-HW-CH-HW-HW-CH-HW-HW-HW-HW-FL-HW-FL-HW-HW-FL-HW-FL-HW-FL-HW-HW-FL-HW-HW-FL-HW-HW-HW-;
HW-HW-FL-HW-FL-HW-HW-FL-HW-HW-HW-HW-FL-HW-FL-HW-HW-FL-HW-FL-HW-FL-CH-HW-FL-HW-FL-FL-HW-HW-HW-;
HW-HW-FL-FL-FL-HW-HW-FL-HW-HW-HW-HW-FL-HW-FL-HW-HW-FL-HW-FL-HW-HW-HW-HW-FL-HW-FL-HW-HW-HW-HW-;
HW-HW-HW-FL-HW-HW-HW-FL-HW-HW-FL-FL-FL-HW-FL-HW-HW-FL-FL-FL-HW-HW-HW-FL-FL-FL-FL-HW-HW-HW-HW-;
HW-HW-HW-FL-FL-FL-FL-FL-HW-HW-FL-HW-FL-HW-FL-HW-HW-HW-HW-HW-HW-HW-FL-FL-HW-HW-HW-HW-HW-HW-HW-;
HW-HW-HW-HW-HW-HW-HW-HW-HW-HW-CH-HW-FL-FL-FL-HW-HW-HW-HW-HW-HW-FL-FL-HW-HW-HW-HW-HW-HW-HW-HW-;
HW-HW-HW-HW-HW-HW-HW-HW-HW-HW-HW-HW-HW-HW-HW-HW-HW-HW-HW-WN-DO-FL-HW-HW-HW-HW-HW-HW-HW-HW-HW-;
HW-HW-HW-HW-HW-HW-HW-HW-HW-HW-HW-HW-HW-HW-HW-HW-HW-HW-HW-HW-HW-HW-HW-HW-HW-HW-HW-HW-HW-HW-HW-;