200/999
WW-WW-WW-WW-WW-WW-WW-WW-WW-WW-WW-WW-WW-WW-WW-WW-WW-WW-WW-WW-WW-WW-WW-WW-WW-WW-WW-WW-WW-WW-WW-;
WW-FI-FI-FI-FI-FI-FI-FI-FI-FI-FI-FI-FI-FI-FI-FI-FI-FI-FI-FI-FI-FI-FI-FI-FI-FI-FI-FI-FI-FI-WW-;
WW-FI-SP-IC-IC-IC-IC-IC-FL-IC-IC-IC-FL-IC-IC-IC-IC-IC-IC-IC-IC-IC-IC-IC-IC-IC-IC-IC-IC-FI-WW-;
WW-FI-IC-IC-IC-IC-IC-IC-IC-IC-IC-IC-IC-IC-IC-IC-IC-IC-IC-IC-IC-IC-IC-IC-IC-IC-IC-IC-IC-FI-WW-;
WW-FI-IC-IC-IC-IC-IC-IC-IC-IC-IC-IC-IC-IC-IC-IC-IC-IC-IC-IC-IC-IC-IC-IC-IC-IC-IC-IC-IC-FI-WW-;
WW-FI-IC-IC-IC-IC-IC-IC-IC-IC-IC-IC-IC-IC-IC-IC-IC-IC-IC-IC-IC-IC-IC-IC-IC-IC-IC-IC-IC-FI-WW-;
WW-FI-IC-IC-IC-IC-IC-IC-IC-IC-IC-IC-FL-IC-IC-IC-FL-IC-IC-IC-IC-IC-IC-IC-IC-IC-IC-IC-IC-FI-WW-;
WW-FI-IC-IC-IC-IC-IC-IC-IC-IC-IC-WW-WW-WW-WW-WW-IC-IC-IC-IC-IC-IC-IC-IC-IC-IC-IC-IC-IC-FI-WW-;
WW-FI-FL-IC-FL-IC-IC-IC-IC-IC-IC-WW-FL-FL-FL-WW-IC-IC-IC-IC-IC-IC-IC-IC-IC-IC-IC-IC-IC-FI-WW-;
WW-FI-IC-IC-IC-IC-IC-IC-IC-IC-IC-WW-FL-WA-FL-IC-IC-IC-FL-IC-IC-FL-IC-IC-CH-IC-IC-IC-IC-FI-WW-;
WW-FI-IC-IC-IC-IC-IC-IC-IC-IC-IC-WW-FL-KR-FL-WW-FL-IC-IC-IC-IC-IC-IC-CH-IC-IC-IC-IC-IC-FI-WW-;
WW-FI-IC-IC-IC-IC-IC-IC-IC-IC-IC-WW-FL-FL-FE-WW-IC-IC-IC-IC-IC-IC-IC-IC-IC-IC-IC-IC-IC-FI-WW-;
WW-FI-IC-IC-FL-IC-FL-IC-IC-IC-IC-WW-WW-WW-WW-WW-IC-IC-IC-IC-IC-IC-IC-IC-IC-IC-IC-IC-IC-FI-WW-;
WW-FI-IC-IC-IC-IC-IC-IC-IC-IC-IC-IC-IC-IC-IC-IC-IC-IC-IC-IC-IC-IC-IC-IC-IC-IC-IC-IC-IC-FI-WW-;
WW-FI-IC-IC-IC-IC-IC-IC-IC-IC-IC-IC-IC-FL-IC-IC-IC-IC-IC-IC-IC-IC-FL-IC-IC-IC-IC-IC-IC-FI-WW-;
WW-FI-IC-IC-IC-IC-IC-IC-IC-IC-IC-IC-IC-FL-IC-IC-IC-IC-FL-IC-IC-IC-IC-IC-IC-IC-IC-IC-IC-FI-WW-;
WW-FI-IC-IC-IC-IC-IC-IC-IC-IC-IC-IC-IC-IC-IC-IC-FL-IC-IC-IC-IC-IC-FL-IC-IC-IC-IC-IC-IC-FI-WW-;
WW-FI-IC-IC-IC-IC-IC-IC-IC-IC-IC-IC-IC-IC-IC-IC-IC-IC-IC-IC-IC-IC-IC-IC-IC-IC-IC-IC-IC-FI-WW-;
WW-FI-IC-IC-IC-IC-FL-IC-IC-IC-IC-IC-IC-IC-IC-IC-IC-IC-IC-IC-IC-IC-IC-IC-IC-IC-IC-IC-IC-FI-WW-;
WW-FI-FI-FI-FI-FI-DR-FI-FI-FI-FI-FI-FI-FI-FI-FI-FI-FI-FI-FI-FI-FI-FI-FI-FI-FI-FI-FI-FI-FI-WW-;
WW-FI-IC-IC-IC-IC-FL-PR-PR-PR-PR-PR-PR-IC-IC-IC-IC-IC-IC-IC-IC-IC-IC-IC-IC-IC-IC-IC-IC-CH-WW-;
WW-FI-IC-IC-IC-IC-DO-FL-IC-IC-IC-IC-IC-IC-IC-IC-IC-IC-IC-IC-IC-IC-IC-IC-IC-IC-IC-IC-IC-FL-WW-;
WW-WW-WW-WW-WW-WW-WN-WW-WW-WW-WW-WW-WW-WW-WW-WW-WW-WW-WW-WW-WW-WW-WW-WW-WW-WW-WW-WW-WW-WW-WW-;
WW-WW-WW-WW-WW-WW-WW-WW-WW-WW-WW-WW-WW-WW-WW-WW-WW-WW-WW-WW-WW-WW-WW-WW-WW-WW-WW-WW-WW-WW-WW-;