700/599
WW-WW-WW-WW-WW-WW-WW-WW-WW-WW-WW-WW-WW-WW-WW-WW-WW-WW-WW-WW-WW-WW-WW-WW-WW-WW-WW-WW-WW-WW-WW-WW-WW-WW-;
WW-SP-FL-FL-FL-FL-FL-FL-FL-FL-FL-FL-FL-FL-FL-FL-FL-FL-FL-FL-FL-FL-FL-FL-FL-FL-FL-FL-FL-FL-FL-FL-FL-WW-;
WW-FL-CH-CH-CH-CH-CH-CH-CH-CH-CH-CH-CH-CH-CH-CH-CH-CH-CH-CH-CH-CH-CH-CH-CH-CH-CH-CH-CH-CH-CH-CH-FL-WW-;
WW-FL-CH-CH-CH-CH-CH-CH-CH-CH-CH-CH-CH-CH-CH-CH-FL-CH-CH-CH-CH-CH-CH-CH-CH-CH-CH-CH-CH-CH-CH-CH-FL-WW-;
WW-FL-CH-CH-CH-CH-CH-CH-CH-CH-CH-CH-CH-CH-CH-CH-WK-CH-CH-CH-CH-CH-CH-CH-CH-CH-CH-CH-CH-CH-CH-CH-FL-WW-;
WW-FL-CH-CH-CH-CH-CH-FL-CH-CH-CH-CH-CH-CH-CH-CH-FL-CH-CH-CH-CH-CH-CH-CH-CH-CH-FL-CH-CH-CH-CH-CH-FL-WW-;
WW-FL-CH-CH-CH-CH-CH-WK-CH-CH-CH-CH-CH-CH-CH-CH-CH-CH-CH-CH-CH-CH-CH-CH-CH-CH-FL-CH-CH-CH-CH-CH-FL-WW-;
WW-FL-CH-CH-CH-CH-CH-FL-CH-CH-CH-CH-CH-CH-CH-CH-CH-CH-CH-CH-CH-CH-FL-FL-FL-FL-TE-FL-FL-CH-CH-CH-FL-WW-;
WW-FL-CH-CH-CH-CH-CH-FL-CH-CH-CH-CH-CH-CH-CH-CH-CH-CH-CH-CH-CH-CH-CH-CH-CH-CH-FL-CH-CH-CH-CH-CH-FL-WW-;
WW-FL-CH-CH-CH-FL-FL-TE-FL-FL-FL-FL-CH-CH-CH-CH-CH-CH-CH-CH-CH-CH-CH-CH-CH-CH-FL-CH-CH-CH-CH-CH-FL-WW-;
WW-FL-CH-CH-CH-CH-CH-FL-CH-CH-CH-CH-CH-CH-CH-CH-CH-CH-CH-CH-CH-CH-CH-CH-CH-CH-FL-CH-CH-CH-CH-CH-FL-WW-;
WW-FL-CH-CH-CH-CH-CH-FL-CH-CH-CH-CH-CH-CH-CH-CH-CH-CH-CH-CH-CH-CH-CH-CH-CH-CH-WK-CH-CH-CH-CH-CH-FL-WW-;
WW-FL-CH-CH-CH-CH-CH-FL-CH-CH-CH-CH-CH-CH-CH-CH-CH-CH-CH-CH-CH-CH-CH-CH-CH-CH-FL-CH-CH-CH-CH-CH-FL-WW-;
WW-FL-CH-CH-CH-CH-CH-FL-CH-CH-CH-CH-CH-CH-DO-DO-DO-CH-CH-CH-CH-CH-CH-CH-CH-CH-FL-CH-CH-CH-CH-CH-FL-WW-;
WW-FL-CH-CH-CH-CH-CH-FL-CH-CH-CH-CH-CH-CH-DO-WN-DO-CH-CH-CH-CH-CH-CH-CH-CH-CH-FL-CH-CH-CH-CH-CH-FL-WW-;
WW-FL-CH-CH-CH-CH-CH-FL-CH-CH-CH-CH-CH-CH-DO-DO-DO-CH-CH-CH-CH-CH-CH-CH-CH-CH-CH-CH-CH-CH-CH-CH-FL-WW-;
WW-FL-CH-CH-CH-CH-CH-CH-CH-CH-CH-CH-CH-CH-CH-CH-CH-CH-CH-CH-CH-FL-CH-CH-CH-CH-CH-CH-CH-CH-CH-CH-FL-WW-;
WW-FL-CH-CH-CH-CH-CH-CH-CH-CH-CH-CH-CH-CH-CH-CH-CH-CH-CH-CH-CH-FL-CH-CH-CH-CH-CH-CH-CH-CH-CH-CH-FL-WW-;
WW-FL-CH-CH-CH-CH-CH-CH-CH-FL-CH-CH-CH-CH-CH-CH-CH-CH-CH-CH-CH-FL-CH-CH-CH-CH-CH-CH-CH-CH-CH-CH-FL-WW-;
WW-FL-CH-CH-CH-CH-CH-CH-CH-FL-CH-CH-CH-CH-CH-CH-CH-CH-CH-CH-CH-FL-CH-CH-CH-CH-CH-CH-CH-CH-CH-CH-FL-WW-;
WW-FL-CH-CH-CH-CH-CH-CH-CH-FL-CH-CH-CH-CH-CH-CH-CH-CH-CH-CH-CH-FL-CH-CH-CH-CH-CH-CH-CH-CH-CH-CH-FL-WW-;
WW-FL-CH-CH-CH-CH-CH-CH-CH-FL-CH-CH-CH-CH-CH-CH-CH-CH-FL-FL-FL-TE-FL-FL-CH-CH-CH-CH-CH-CH-CH-CH-FL-WW-;
WW-FL-CH-CH-CH-CH-CH-CH-CH-FL-CH-CH-CH-CH-CH-CH-CH-CH-CH-CH-CH-FL-CH-CH-CH-CH-CH-CH-CH-CH-CH-CH-FL-WW-;
WW-FL-CH-CH-CH-CH-CH-CH-CH-FL-CH-CH-CH-CH-CH-CH-CH-CH-CH-CH-CH-FL-CH-CH-CH-CH-CH-CH-CH-CH-CH-CH-FL-WW-;
WW-FL-CH-CH-CH-CH-FL-FL-FL-TE-FL-FL-FL-FL-CH-CH-CH-CH-CH-CH-CH-FL-CH-CH-CH-CH-CH-CH-CH-CH-CH-CH-FL-WW-;
WW-FL-CH-CH-CH-CH-CH-CH-CH-FL-CH-CH-CH-CH-CH-CH-CH-CH-CH-CH-CH-CH-CH-CH-CH-CH-CH-CH-CH-CH-CH-CH-FL-WW-;
WW-FL-CH-CH-CH-CH-CH-CH-CH-FL-CH-CH-CH-CH-CH-CH-CH-CH-CH-CH-CH-CH-CH-FL-CH-CH-CH-CH-CH-CH-CH-CH-FL-WW-;
WW-FL-CH-CH-CH-CH-CH-CH-CH-FL-CH-CH-CH-CH-CH-CH-CH-CH-CH-CH-CH-CH-CH-FL-CH-CH-CH-CH-CH-CH-CH-CH-FL-WW-;
WW-FL-CH-CH-CH-CH-CH-CH-CH-CH-CH-CH-CH-CH-FL-CH-CH-CH-CH-CH-CH-CH-CH-FL-CH-CH-CH-CH-CH-CH-CH-CH-FL-WW-;
WW-FL-CH-CH-CH-CH-CH-CH-CH-CH-CH-CH-CH-CH-FL-CH-CH-CH-CH-CH-FL-FL-FL-WK-FL-FL-FL-FL-FL-CH-CH-CH-FL-WW-;
WW-FL-CH-CH-CH-CH-CH-CH-CH-CH-CH-CH-CH-CH-WK-CH-CH-CH-CH-CH-CH-CH-CH-FL-CH-CH-CH-CH-CH-CH-CH-CH-FL-WW-;
WW-FL-CH-CH-CH-CH-CH-CH-CH-CH-CH-CH-CH-CH-FL-CH-CH-CH-CH-CH-CH-CH-CH-FL-CH-CH-CH-CH-CH-CH-CH-CH-FL-WW-;
WW-FL-CH-CH-CH-CH-CH-CH-CH-CH-CH-CH-CH-CH-FL-CH-CH-CH-CH-CH-CH-CH-CH-FL-CH-CH-CH-CH-CH-CH-CH-CH-FL-WW-;
WW-FL-CH-CH-CH-CH-CH-CH-CH-CH-CH-CH-CH-CH-CH-CH-CH-CH-CH-CH-CH-CH-CH-CH-CH-CH-CH-CH-CH-CH-CH-CH-FL-WW-;
WW-FL-FL-FL-FL-FL-FL-FL-FL-FL-FL-FL-FL-FL-FL-FL-FL-FL-FL-FL-FL-FL-FL-FL-FL-FL-FL-FL-FL-FL-FL-FL-TE-WW-;
WW-WW-WW-WW-WW-WW-WW-WW-WW-WW-WW-WW-WW-WW-WW-WW-WW-WW-WW-WW-WW-WW-WW-WW-WW-WW-WW-WW-WW-WW-WW-WW-WW-WW-;