250/999
WW-WW-WW-WW-WW-WW-WW-WW-WW-WW-WW-WW-WW-WW-WW-WW-WW-WW-WW-WW-WW-WW-WW-WW-WW-WW-WW-WW-WW-WW-WW-;
WW-GR-GR-GR-GR-GR-GR-GR-GR-GR-GR-GR-GR-GR-GR-GR-GR-GR-GR-GR-GR-GR-GR-GR-GR-GR-GR-GR-GR-GR-WW-;
WW-GR-CH-CH-CH-GR-CH-FL-FL-GR-FL-FL-FL-GR-FL-FL-BL-GR-FL-FL-FL-GR-FL-CH-FL-GR-FL-FL-BL-GR-WW-;
WW-GR-CH-SP-CH-GR-FL-BL-FL-CH-FL-FL-FL-CH-FL-CH-FL-CH-FL-FL-BL-CH-FL-FL-FL-CH-FL-FL-FL-GR-WW-;
WW-GR-CH-CH-CH-GR-FL-FL-FL-GR-FL-BL-CH-GR-FL-FL-FL-GR-FL-FL-CH-GR-FL-FL-FL-GR-FL-CH-FL-GR-WW-;
WW-GR-GR-GR-GR-GR-GR-GR-GR-GR-GR-GR-GR-GR-GR-GR-GR-GR-GR-GR-GR-GR-GR-GR-GR-GR-GR-CH-GR-GR-WW-;
WW-GR-FL-FL-FL-GR-FL-FL-CH-GR-FL-FL-FL-GR-FL-CH-FL-GR-FL-FL-FL-GR-FL-BL-FL-GR-FL-FL-FL-GR-WW-;
WW-GR-CH-BL-FL-CH-BL-FL-FL-CH-FL-FL-FL-CH-BL-FL-FL-CH-BL-FL-FL-CH-FL-FL-CH-CH-FL-CH-FL-GR-WW-;
WW-GR-FL-FL-FL-GR-FL-FL-FL-GR-BL-CH-FL-GR-FL-FL-FL-GR-FL-CH-FL-GR-FL-FL-FL-GR-FL-BL-CH-GR-WW-;
WW-GR-GR-CH-GR-GR-GR-GR-GR-GR-GR-GR-GR-GR-GR-GR-GR-GR-GR-GR-GR-GR-GR-GR-GR-GR-GR-CH-GR-GR-WW-;
WW-GR-FL-FL-FL-GR-BL-FL-FL-GR-FL-FL-FL-GR-DO-DO-DO-GR-FL-FL-FL-GR-FL-FL-FL-GR-FL-BL-FL-GR-WW-;
WW-GR-BL-FL-FL-CH-FL-FL-FL-CH-FL-BL-FL-CH-DO-WN-DO-CH-FL-BL-FL-CH-FL-BL-FL-CH-FL-FL-FL-GR-WW-;
WW-GR-FL-FL-FL-GR-FL-FL-FL-GR-FL-FL-FL-GR-DO-DO-DO-GR-FL-FL-FL-GR-FL-FL-FL-GR-FL-FL-FL-GR-WW-;
WW-GR-GR-CH-GR-GR-GR-GR-GR-GR-GR-GR-GR-GR-GR-GR-GR-GR-GR-GR-GR-GR-GR-GR-GR-GR-GR-CH-GR-GR-WW-;
WW-GR-FL-FL-FL-GR-FL-CH-FL-GR-FL-FL-FL-GR-FL-FL-CH-GR-FL-BL-FL-GR-FL-FL-CH-GR-FL-CH-FL-GR-WW-;
WW-GR-CH-BL-FL-CH-FL-BL-FL-CH-FL-CH-BL-CH-FL-FL-BL-CH-FL-FL-FL-CH-FL-BL-FL-CH-FL-FL-BL-GR-WW-;
WW-GR-FL-FL-FL-GR-FL-FL-FL-GR-FL-FL-FL-GR-FL-FL-FL-GR-FL-FL-CH-GR-FL-FL-FL-GR-FL-FL-FL-GR-WW-;
WW-GR-GR-CH-GR-GR-GR-GR-GR-GR-GR-GR-GR-GR-GR-GR-GR-GR-GR-GR-GR-GR-GR-GR-GR-GR-GR-CH-GR-GR-WW-;
WW-GR-BL-FL-FL-GR-FL-FL-FL-GR-FL-FL-CH-GR-CH-FL-FL-GR-FL-FL-FL-GR-FL-FL-FL-GR-FL-BL-CH-GR-WW-;
WW-GR-FL-CH-FL-CH-FL-CH-FL-CH-FL-FL-FL-CH-FL-BL-FL-CH-FL-BL-FL-CH-FL-BL-CH-CH-FL-FL-FL-GR-WW-;
WW-GR-FL-FL-FL-GR-FL-BL-FL-GR-FL-BL-FL-GR-FL-FL-FL-GR-CH-FL-FL-GR-FL-FL-FL-GR-FL-FL-FL-GR-WW-;
WW-GR-GR-GR-GR-GR-GR-GR-GR-GR-GR-GR-GR-GR-GR-GR-GR-GR-GR-GR-GR-GR-GR-GR-GR-GR-GR-GR-GR-GR-WW-;
WW-WW-WW-WW-WW-WW-WW-WW-WW-WW-WW-WW-WW-WW-WW-WW-WW-WW-WW-WW-WW-WW-WW-WW-WW-WW-WW-WW-WW-WW-WW-;