200/999
WW-WW-WW-WW-WW-WW-WW-WW-WW-WW-WW-WW-WW-WW-WW-WW-WW-WW-WW-WW-WW-WW-WW-WW-WW-WW-WW-WW-WW-WW-WW-WW-WW-WW-WW-WW-WW-WW-WW-WW-WW-WW-WW-WW-WW-;
WW-WA-WA-WA-WA-WA-WA-WA-WA-WA-WA-WA-WA-WA-WA-WA-WA-WA-WA-WA-WA-WA-WA-WA-WA-WA-WA-WA-WA-WA-WA-WA-WA-WA-WA-WA-WA-WA-WA-WA-WA-WA-WA-WA-WA-WA-;
WW-WA-IC-IC-IC-IC-IC-IC-IC-IC-IC-IC-IC-IC-IC-IC-IC-IC-IC-IC-IC-IC-IC-IC-IC-IC-IC-IC-NW-NE-IC-IC-IC-IC-IC-IC-IC-IC-IC-IC-WA-WA-WA-WA-WA-WA-;
WW-WA-IC-NW-IC-IC-NE-IC-IC-IC-IC-IC-IC-IC-IC-IC-IC-IC-IC-IC-IC-IC-IC-IC-IC-IC-IC-IC-IC-IC-IC-IC-IC-IC-IC-IC-IC-IC-IC-IC-WA-WA-WA-WA-WA-WA-;
WW-WA-IC-IC-IC-IC-IC-IC-IC-IC-IC-NW-IC-IC-IC-IC-IC-FL-IC-IC-IC-IC-NE-NW-IC-IC-IC-IC-FL-IC-IC-IC-IC-IC-IC-IC-IC-IC-IC-IC-WA-WA-WA-WA-WA-WA-;
WW-WA-IC-IC-IC-IC-IC-IC-IC-IC-IC-IC-IC-IC-IC-IC-IC-IC-IC-IC-IC-IC-IC-IC-IC-IC-IC-IC-IC-IC-IC-IC-IC-IC-IC-IC-IC-IC-IC-IC-WA-WA-WA-WA-WA-WA-;
WW-WA-IC-IC-IC-IC-IC-IC-IC-IC-IC-IC-IC-IC-IC-IC-IC-IC-IC-NW-IC-IC-IC-SE-IC-IC-IC-NW-IC-IC-NE-IC-IC-IC-IC-IC-IC-IC-IC-IC-WA-WA-WA-WA-WA-WA-;
WW-WA-IC-IC-IC-IC-IC-IC-IC-IC-IC-IC-IC-IC-IC-IC-IC-IC-IC-IC-IC-IC-IC-IC-IC-IC-IC-IC-IC-IC-IC-IC-IC-IC-IC-IC-IC-IC-IC-IC-WA-WA-WA-WA-WA-WA-;
WW-WA-IC-IC-IC-IC-IC-IC-IC-IC-NW-IC-IC-IC-IC-NE-IC-IC-IC-IC-IC-IC-IC-IC-IC-IC-IC-SW-IC-SE-IC-IC-IC-IC-IC-IC-IC-IC-IC-IC-WA-WA-WA-WA-WA-WA-;
WW-WA-IC-IC-IC-IC-IC-IC-IC-IC-IC-IC-IC-IC-IC-IC-IC-IC-IC-IC-IC-IC-IC-IC-IC-IC-IC-IC-IC-IC-IC-IC-IC-IC-IC-IC-IC-IC-IC-IC-WA-WA-WA-WA-WA-WA-;
WW-WA-IC-IC-IC-IC-IC-IC-IC-IC-IC-IC-IC-IC-IC-IC-IC-IC-IC-IC-IC-IC-IC-IC-IC-IC-IC-IC-IC-IC-IC-IC-IC-IC-IC-IC-IC-IC-IC-IC-WA-WA-WA-WA-WA-WA-;
WW-WA-IC-IC-IC-IC-IC-IC-IC-IC-IC-SE-IC-IC-IC-IC-NW-IC-NE-IC-IC-IC-IC-IC-IC-IC-IC-IC-IC-IC-IC-IC-IC-IC-IC-IC-IC-IC-IC-IC-WA-WA-WA-WA-WA-WA-;
WW-WA-IC-IC-IC-IC-IC-IC-IC-NW-FL-IC-SE-IC-IC-IC-IC-IC-IC-IC-IC-IC-WA-IC-IC-IC-IC-IC-IC-IC-IC-NW-IC-IC-NE-IC-IC-IC-IC-IC-WA-WA-WA-WA-WA-WA-;
WW-WA-IC-IC-NW-IC-FL-IC-IC-IC-IC-IC-IC-NE-IC-IC-IC-IC-IC-IC-IC-IC-IC-IC-NW-NE-IC-IC-IC-IC-IC-IC-NW-NE-IC-IC-IC-IC-IC-IC-WA-WA-WA-WA-WA-WA-;
WW-WA-IC-IC-IC-IC-IC-IC-IC-IC-IC-IC-IC-IC-IC-IC-IC-IC-IC-FL-IC-IC-IC-IC-IC-SE-IC-IC-IC-IC-IC-IC-IC-IC-IC-IC-IC-IC-IC-IC-WA-WA-WA-WA-WA-WA-;
WW-WA-IC-IC-IC-IC-IC-IC-IC-IC-IC-IC-IC-IC-IC-IC-IC-WA-IC-IC-IC-IC-IC-IC-IC-IC-IC-IC-IC-IC-SW-IC-FL-IC-IC-NE-IC-IC-IC-IC-WA-WA-WA-WA-WA-WA-;
WW-WA-IC-IC-IC-IC-IC-IC-IC-IC-SW-IC-IC-IC-IC-IC-SE-IC-IC-IC-IC-IC-IC-IC-IC-IC-IC-IC-IC-IC-IC-SW-IC-SE-IC-IC-IC-IC-IC-IC-WA-WA-WA-WA-WA-WA-;
WW-WA-IC-IC-SW-NE-IC-IC-IC-IC-IC-IC-IC-HP-IC-IC-IC-IC-IC-IC-IC-IC-IC-IC-IC-IC-IC-IC-IC-IC-IC-NW-IC-IC-SE-IC-IC-IC-IC-IC-WA-WA-WA-WA-WA-WA-;
WW-WA-IC-IC-IC-IC-IC-IC-IC-IC-IC-NW-IC-FL-SE-IC-IC-IC-IC-IC-NW-IC-IC-IC-IC-NE-IC-IC-IC-IC-IC-IC-IC-IC-IC-IC-IC-IC-IC-IC-WA-WA-WA-WA-WA-WA-;
WW-WA-IC-IC-IC-IC-IC-IC-IC-IC-IC-IC-IC-IC-IC-IC-IC-IC-IC-IC-IC-IC-IC-IC-IC-IC-IC-IC-IC-WA-IC-IC-IC-IC-IC-FL-IC-IC-IC-SE-WA-WA-WA-WA-WA-WA-;
WW-WA-IC-IC-IC-IC-IC-NW-NE-IC-IC-IC-IC-IC-IC-IC-IC-NW-SP-IC-IC-FL-IC-IC-IC-IC-IC-IC-IC-FL-IC-IC-IC-IC-IC-IC-IC-IC-IC-IC-WA-WA-WA-WA-WA-WA-;
WW-WA-IC-IC-IC-IC-IC-IC-IC-WA-IC-IC-IC-SW-IC-SE-IC-IC-IC-IC-IC-WA-IC-WA-IC-IC-IC-IC-IC-IC-IC-IC-IC-IC-IC-SW-IC-IC-IC-NE-WA-WA-WA-WA-WA-WA-;
WW-WA-IC-IC-IC-IC-IC-IC-IC-IC-IC-SW-NE-IC-IC-IC-IC-IC-SW-FL-IC-IC-IC-IC-IC-IC-NE-IC-IC-IC-IC-IC-IC-WA-IC-IC-WA-IC-IC-IC-WA-WA-WA-WA-WA-WA-;
WW-WA-IC-SW-IC-IC-IC-IC-FL-NE-IC-IC-IC-IC-IC-IC-IC-IC-NW-IC-IC-IC-IC-IC-FL-IC-IC-IC-NW-IC-IC-IC-IC-FL-IC-IC-NE-IC-IC-IC-WA-WA-WA-WA-WA-WA-;
WW-WA-IC-IC-NW-SE-IC-IC-WA-IC-IC-IC-IC-IC-IC-IC-IC-IC-IC-IC-IC-NW-NE-IC-IC-IC-IC-IC-IC-IC-IC-IC-IC-IC-IC-IC-IC-IC-IC-IC-WA-WA-WA-WA-WA-WA-;
WW-WA-IC-IC-IC-IC-IC-IC-IC-IC-IC-IC-IC-IC-IC-IC-IC-IC-IC-IC-IC-FL-IC-IC-IC-IC-IC-IC-IC-IC-IC-IC-IC-IC-IC-IC-IC-IC-IC-IC-WA-WA-WA-WA-WA-WA-;
WW-WA-IC-IC-IC-IC-IC-IC-IC-SW-IC-IC-IC-IC-NE-IC-IC-SW-IC-IC-IC-IC-IC-IC-IC-IC-IC-IC-FL-IC-IC-IC-IC-IC-IC-IC-IC-IC-IC-IC-WA-WA-WA-WA-WA-WA-;
WW-WA-IC-IC-IC-IC-IC-IC-IC-IC-IC-IC-WA-IC-IC-IC-IC-IC-IC-IC-SW-SE-IC-IC-IC-FL-IC-IC-IC-IC-IC-SE-IC-SW-IC-IC-IC-IC-IC-IC-WA-WA-WA-WA-WA-WA-;
WW-WA-IC-IC-IC-IC-IC-SW-IC-IC-NE-IC-IC-IC-FL-NE-IC-IC-IC-IC-IC-IC-IC-IC-IC-IC-IC-IC-IC-IC-IC-IC-IC-IC-IC-IC-IC-IC-IC-IC-WA-WA-WA-WA-WA-WA-;
WW-WA-IC-IC-IC-IC-IC-IC-IC-IC-IC-IC-IC-IC-IC-IC-IC-IC-IC-IC-IC-IC-IC-IC-IC-IC-IC-IC-IC-IC-IC-IC-IC-IC-IC-IC-IC-IC-IC-IC-WA-WA-WA-WA-WA-WA-;
WW-WA-IC-IC-IC-IC-IC-IC-IC-IC-IC-IC-IC-IC-IC-IC-IC-FL-IC-IC-IC-IC-IC-IC-IC-IC-SE-IC-IC-IC-NW-IC-IC-IC-IC-IC-FL-IC-IC-IC-WA-WA-WA-WA-WA-WA-;
WW-WA-IC-IC-IC-IC-IC-IC-FL-IC-IC-IC-IC-IC-IC-IC-IC-SE-IC-IC-IC-WW-FL-WW-IC-IC-IC-IC-IC-IC-IC-IC-IC-IC-IC-IC-IC-IC-IC-IC-WA-WA-WA-WA-WA-WA-;
WW-WA-IC-IC-IC-IC-IC-IC-IC-IC-SW-IC-IC-IC-IC-IC-IC-IC-FL-IC-IC-WW-WN-WW-IC-IC-IC-IC-IC-IC-IC-IC-IC-IC-IC-IC-IC-IC-IC-IC-WA-WA-WA-WA-WA-WA-;
WW-WA-WA-IC-IC-IC-IC-IC-SE-IC-IC-IC-IC-IC-IC-IC-IC-IC-IC-IC-IC-WW-WW-WW-IC-IC-IC-IC-IC-IC-IC-IC-IC-IC-IC-IC-IC-IC-IC-IC-WA-WA-WA-WA-WA-WA-;
WW-WA-IC-IC-IC-IC-IC-IC-IC-IC-IC-IC-IC-IC-IC-IC-IC-IC-IC-IC-IC-IC-IC-IC-IC-IC-IC-IC-IC-IC-IC-IC-IC-IC-IC-IC-IC-IC-IC-IC-WA-WA-WA-WA-WA-WA-;
WW-WA-WA-WA-WA-WA-WA-WA-WA-WA-WA-WA-WA-WA-WA-WA-WA-WA-WA-WA-WA-WA-WA-WA-WA-WA-WA-WA-WA-WA-WA-WA-WA-WA-WA-WA-WA-WA-WA-WA-WA-WA-WA-WA-WA-WA-;
WW-WA-WA-WA-WA-WA-WA-WA-WA-WA-WA-WA-WA-WA-WA-WA-WA-WA-WA-WA-WA-WA-WA-WA-WA-WA-WA-WA-WA-WA-WA-WA-WA-WA-WA-WA-WA-WA-WA-WA-WA-WA-WA-WA-WA-WA-;
WW-WA-WA-WA-WA-WA-WA-WA-WA-WA-WA-WA-WA-WA-WA-WA-WA-WA-WA-WA-WA-WA-WA-WA-WA-WA-WA-WA-WA-WA-WA-WA-WA-WA-WA-WA-WA-WA-WA-WA-WA-WA-WA-WA-WA-WA-;
WW-WA-WA-WA-WA-WA-WA-WA-WA-WA-WA-WA-WA-WA-WA-WA-WA-WA-WA-WA-WA-WA-WA-WA-WA-WA-WA-WA-WA-WA-WA-WA-WA-WA-WA-WA-WA-WA-WA-WA-WA-WA-WA-WA-WA-WA-;
WW-WA-WA-WA-WA-WA-WA-WA-WA-WA-WA-WA-WA-WA-WA-WA-WA-WA-WA-WA-WA-WA-WA-WA-WA-WA-WA-WA-WA-WA-WA-WA-WA-WA-WA-WA-WA-WA-WA-WA-WA-WA-WA-WA-WA-WA-;
WW-WA-WA-WA-WA-WA-WA-WA-WA-WA-WA-WA-WA-WA-WA-WA-WA-WA-WA-WA-WA-WA-WA-WA-WA-WA-WA-WA-WA-WA-WA-WA-WA-WA-WA-WA-WA-WA-WA-WA-WA-WA-WA-WA-WA-WA-;