200/008
WW-WW-WW-WW-WW-WW-WW-WW-WW-WW-WW-WW-WW-WW-WW-WW-WW-WW-WW-WW-WW-WW-WW-WW-WW-WW-;
WW-WW-WW-WW-WW-WW-FL-FL-FL-WW-WW-WW-WW-WW-WW-WW-WW-WW-WW-WW-WW-WW-WW-WW-WW-WW-;
WW-WW-WW-WW-WW-WW-FE-WW-FL-WW-WW-FL-FL-FL-FL-FL-FL-FL-FL-KR-WW-WW-WW-WW-WW-WW-;
WW-WW-WW-FL-FL-FL-FL-WW-FL-FL-FL-FL-WW-WW-WW-WW-WW-FL-WW-WW-WW-WW-WW-WW-WW-WW-;
WW-WW-WW-FL-WW-WW-FL-FL-FL-WW-WW-FL-WW-WW-WW-WW-WW-FL-WW-WW-WW-WW-WW-WW-WW-WW-;
WW-FL-FL-FL-FL-WW-WW-WW-WW-WW-WW-FL-FI-FI-FI-FI-WW-FL-WW-WW-WW-WW-WW-CH-WW-WW-;
WW-FL-FL-DT-FL-WW-WW-KG-WW-WW-WW-TH-WW-WW-WW-FI-WW-FL-WW-WW-WW-WW-WW-BR-WW-WW-WW-;
WW-FL-DT-FL-FL-WW-WW-FL-WW-WW-FL-FL-FL-WW-WW-FI-WW-FL-FL-FL-FL-FL-FL-FL-BR-CH-WW-;
WW-FL-DT-FL-FL-WW-WW-FL-WW-WW-FL-HP-FL-WW-WW-CH-WW-WW-WW-WW-WW-FL-WW-BF-WW-WW-WW-;
WW-WW-WA-WW-WW-WW-WW-FL-WW-WW-FL-FL-FL-WW-WW-WW-WW-WW-WW-WW-WW-FL-WW-CH-WW-WW-;
WW-WW-WA-WW-FP-FL-FL-FL-FL-FL-FL-SP-FL-WW-WW-WW-WW-WW-WW-WW-WW-FL-WW-WW-WW-WW-;
WW-WW-WA-WW-WW-WW-WW-WW-WW-WW-FI-WW-FL-WW-WW-WW-WW-WW-WW-WW-WW-FL-WW-WW-WW-WW-;
WW-WW-CH-WW-WW-WW-WW-WW-WW-WW-FI-WW-FL-WW-WW-WW-WW-WW-WW-WW-WW-DR-WW-WW-WW-WW-;
WW-WW-FL-WW-WW-WW-WW-WW-WW-WW-FI-WW-FB-WW-WW-WW-WW-WW-WW-WW-WW-DG-WW-WW-WW-WW-;
WW-WW-FL-WW-PD-PL-PL-PL-PL-PL-CH-WW-PU-PL-PL-PL-PL-PL-PL-WW-WW-DY-WW-WW-WW-WW-;
WW-WW-FL-WW-PD-WW-WW-WW-WW-WW-WW-WW-WW-WW-WW-WW-WW-WW-CH-WW-WW-DB-WW-WW-WW-WW-;
WW-WW-FL-WW-PD-WW-WW-WW-WW-FL-CH-FL-WW-FL-CH-FL-WW-WW-WA-WW-WW-DO-WW-WW-WW-WW-;
WW-WW-FL-WW-PR-PR-PR-PR-PR-PR-PR-PR-PR-PR-PR-PR-PR-PR-PU-WW-WW-WN-WW-WW-WW-WW-;
WW-WW-FL-WW-WW-WW-WW-WW-WW-WW-FL-WW-FL-WW-FL-WW-WW-WW-WW-WW-WW-WW-WW-WW-WW-WW-;
WW-WW-FL-WW-WW-WW-WW-WW-WW-WW-FL-FL-KY-FL-FL-WW-WW-WW-WW-WW-WW-WW-WW-WW-WW-WW-;
WW-FL-BH-FL-FL-FL-FL-FL-WW-WW-WW-WW-WW-WW-WW-WW-WW-WW-WW-WW-WW-WW-WW-WW-WW-WW-;
WW-WW-WW-WW-FL-WW-WW-WW-WW-WW-CH-FL-FL-FL-BO-BO-BO-BO-BO-FL-FL-FL-WW-WW-WW-WW-;
WW-WW-WW-WW-FL-WW-WW-WW-WW-WW-BO-BO-BO-FL-FL-FL-BO-FL-FL-FL-BO-FL-WW-WW-WW-WW-;
WW-WW-WW-WW-FL-FL-FL-FL-FL-FL-FL-FL-BO-FL-BO-FL-BO-FL-BO-BO-BO-FL-WW-WW-WW-WW-;
WW-WW-WW-WW-KB-WW-WW-WW-WW-WW-BO-FL-BO-FL-BO-FL-BO-FL-BO-CH-BO-FL-WW-WW-WW-WW-;
WW-WW-WW-WW-WW-WW-WW-WW-WW-WW-BO-FL-FL-FL-BO-FL-FL-FL-BO-FL-FL-FL-WW-WW-WW-WW-;
WW-WW-WW-WW-WW-WW-WW-WW-WW-WW-WW-WW-WW-WW-WW-WW-WW-WW-WW-WW-WW-WW-WW-WW-WW-WW-;